집에 오래 전부터 있었지만 한 번도 관심있게 들여다 보지 않다가, 본격적으로 군생활을 하면서 행정업무를 하면서 정말 일을 열심히 하였다. 실제로 윗사람들에게 많이 인정 받기도 했으나, 결국 인간관계에 트러블이 생기면서 행정업무를 못하게 되었다. 그 이후, 집에 꽂혀 있던 이 책을 보자 '나는 분명 열심히 했는데.. 왜?' 라는 생각과 함께 읽게 된 책이다.

  이 책의 저자인 '마셜 골드스미스'는 세계에서 가장 영향력 있는 리더십 전문가이자 코치이다. 실제로 그가 코칭하는 사람들 중에는 각종 기업과 정계의 거물들이 많은 것으로 유명하다. 그런 그가 자신이 일하면서 겪은 경험들을 바탕으로 이 책을 저술했다고 한다.

  마셜 골드스미스는 일을 못하는 사람들을 위해 이 책을 저술한 것이 아니라, '이미 잘하고 있지만 앞으로 더욱 성장하고 발전하여 다음 단계의 성공으로 나아가고자 하는 리더'들을 위해 저술했다고 한다. 그리고 그는 가장 중요한 성공의 요인으로 '인간관계'를 지적했다. 아무리 고도로 전문적인 직종이라하더라도, 사람 사이의 일이 잘못되어 성공의 코앞에서 꺾이는 일이 많다면서, 대부분의 사람들은 조직 내에서 일을 하고 조직 내의 '인간관계'에서 자신의 작은 결점들을 방치하고, 이는 치명적인 실수로 이어져, 결국 성공을 방해하는 큰 장애물이 된다는 것이다.
  실제로, 나의 경우도 일에서 문제가 터진 것이 아니라 '인간관계'에서 문제가 발생했기에, 매우 공감이 되었다.
그는 조직내 '성공을 위한 인간관계'에 대해 점검, 성공을 방해하는 20가지 걸림돌, 성공을 내편으로 만드는 7가지 원칙, 성공을 지속시키는 8가지 변화의 규칙 이렇게 네 부분으로 나눠 저술하였는데 하나씩 요약해보도록 하겠다.

* 성공은 현재를 점검하는 데서 출발한다.
현재 당신이 서있는 위치를 점검하라. 진실은 다른 사람의 평가에서 나오니 다른 사람의 평가를 신뢰하라.


* 성공을 가로막는 20가지 실수들
1. 과도한 승부욕 : 이기는 것 자체가 목적이 되어 에너지를 낭비하게 된다.
2. 지나친 의견추가 : 함께 일하는 사람의 의욕을 꺾어놓거나 반감시킨다.
3. 쓸데없는 비평 : 사람들이 방어적 태도를 취하며 점점 멀어진다.
4. 파괴적인 말 : 상대에게 상처를 입히고 적으로 돌아서게 한다.
5. 부정적 표현 : 대화를 목적 없는 싸움으로 흘러가게 만든다.
6. 잘난 척 하기 : 똑똑해 보이려고 할수록 더욱 바보 취급을 받는다.
7. 격한 감정 : 강한 모습을 보이려다 우스꽝스러운 사람으로 비춰진다.
8. 반대의견 : 정보가 차단된 채 자신의 책상 앞에 홀로 앉아 있게 된다.
9. 정보의 독점 : 사람들을 소외시킴으로써 오해와 불신을 키운다.
10. 인색한 칭찬 : 불공평한 사람이라는 인상 때문에 사람들이 떠난다.
11. 남의 공 가로채기 : 부당한 희생자를 만들어 분노를 표출시킨다.
12. 변명 : 새로운 기회와 숨겨진 재능을 잃어버린다.
13. 핑계 : 아무런 소득도 없이 문제는 해결되지 않은 채 남아있다.
14. 편애 : 실력 있고 정직한 사람들에게 불이익이 돌아간다.
15. 사과하지 않기 : 사람들의 도움을 얻어낼 수많은 기회를 떠나보낸다.
16. 경청하지 않기 : 당신보다 더 능력 있는 직원들을 떠나게 만든다.
17. 감사하지 않기 : 조용히 끝날 수 있는 일을 요란하게 만든다.
18. 엉뚱한 화풀이 : 문제를 바로잡을 수 있는 타이밍을 놓쳐버린다.
19. 책임 전가 : 위기를 모면하려다 더 큰 위기에 부딪힌다.
20. 자기 미화 : 당신에게 필요한 변화를 시작할 수 없다.
* 성공을 내편으로 만드는 7가지 원칙
1. 피드백 - 다른 사람의 눈으로 자신을 바라보고, 실제로 남들에게 피드백을 받아 발전의 기초로 삼아라.
2. 사과 - 자신의 문제점을 솔직하게 인정하고 잘못된 부분은 고치려 노력하라.
3. 선언 - 잘못된 부분 변화하겠다는 의지를 알리고 도움을 구하라. (지키지 않을시 벌금형이라던지)
4. 경청 - 상대의 평가에 적극적으로 귀 기울이고, 그 외의 의견에도 귀를 기울여라.
5. 감사 - 자신의 부족함을 겸허하게 받아들이고, 남들에게 항상 감사할 줄 알라.
6. 폴로업 - 사람들의 평가를 지속적으로 점검하고 반성하고 체크하라.
7. 피드포워드 - 과거는 이제 흘려보내고 성공적인 미래의 목표를 설정하라.
* 성공을 지속시키는 리더에 도전하는 사람들을 위한 특변한 조언
1. 직원들에게 당신을 어떻게 대해야 할지 구체적으로 알려라.
2. 직원들이 당신을 압도하게 하지 마라.
3. 모두가 당신과 같아지기를 강요하지 마라.
4. 실행이 완료될 때까지 폴로업을 멈추지 마라
5. 직원들에 대한 4가지 잘못된 편견을 중단하라.
(나는 그들이 무엇을 원하는지 알고 있고, 그들이 아는 것을 알고, 그들의 이기심을 싫어하고, 언제나 다른 사람을 구할 수 있다.)
6. 코칭하면 안 될 사람을 코칭하지 말라.  인간관계에서 더 나아지기 위한 핵심은 다름 아닌 '피드백'과 '변화하겠다는 의지'가 가장 중요하다는 것을 배웠다. 고객에게는 피드백을 받아서 더 나은 서비스를 제공하려하면서 정작 자기자신의 주변에있는 사람은 훨씬 중요한데도 왜 피드백을 받지 않냐는게 이 책의 저자의 요지였다. 나의 경우에 문제점은 '지나친 의견추가, 격한 감정'이 문제라는 사실을 알게되었고 앞으로는 더 주의하면서 훨씬 사람들과의 나은 인간관계를 유지하지 않을까라는 생각이 든다. 항상 어릴때부터 동갑인 친구들과 어울려서 지내다가 이제 사회에서 군대에 입대해서 제대로된 상하관계에 처음으로 발을 들이다보니, 내가 지금까지 생각하는 인간관계에 대한 것과 너무나 차이가 많았다. 윗사람은 윗사람대로 대하기 어렵고, 아랫사람은 아랫사람대로 대하기가 어려웠다. 하지만 어떤 자세로 이 상하관계로 구성된 사회생활을 해야하는지 이 책이 많이 가르쳐 주는 것 같다.  정상에 오르지 못하는 97%의 사람들은 자신이 모르는 자신의 3%의 결점 때문에 정상에 오르지 못 한다고 한다. 나의 3%의 결점을 고쳐서 비록 정상엔 오르지 못 하더라도, 조금 더 나은 '나'가 되었으면 좋겠다.